French Montana - No Stylist
BROCKHAMPTON - J'OUVERT
Dinah Jane - Bottled Up
Lil Peep - Falling Down
The Chainsmokers - This Feeling
Rita Ora - Let You Love Me
Mumford & Sons - Guiding Light
Whethan - Radar (feat. HONNE)
Bantu - Roll With Me (feat. Shungudzo & ZieZie)
Lil Uzi Vert - New Patek
Jeremy Zucker - thinking 2 much
Fuego - Good Vibes
Avril Lavigne - Head Above Water
Lana Del Rey - Venice Bitch
YoungBoy Never Broke Again - Sky Cry
Bhad Bhabie - Geek'd (feat. Lil Baby)
Loote - Back Together
Josh Groban - 99 Years (feat. Jennifer Nettles)
Melii - Como Si Na
San Holo - show me
Alina Baraz - Feels Right
Christine and the Queens - The walker
Chris Cornell - When Bad Does Good
BROCKHAMPTON - NEW ORLEANS
The Band Perry - NOSTALGIA
Imagine Dragons - Zero
Lil Xan - Emotions
Moby Rich - Yoko Ono
Weezer - California Snow
Machine Gun Kelly - GET THE BROOM
Tyga - Swap Meet
HRVY - I Wish You Were Here
bülow - Two Punks In Love
The Neighbourhood - Paradise
Rudy Mancuso - Lento
Andy Mineo - Friends
Young Dolph - Break The Bank (feat. Offset)
Jagwar Twin - Good Day
Skyler Stonestreet - It Kinda Hurts
J.I.D - 151 Rum
Avenged Sevenfold - Mad Hatter
KYLE - SUPERDUPERKYLE (feat. MadeinTYO)
Kesha - Here Comes The Change
Lewis Capaldi - Grace
Famous Dex - Nervous (feat. Lil Baby, Jay Critch & Rich the Kid)
Noah Cyrus - Punches (feat. LP)
SOB X RBE - Made It (feat. Yhung T.O., Lul G & DaBoii)
Chadwick - Pacific
Au/Ra - Emoji
AJR - Role Models
MØ - Imaginary Friend
KOPS - Salvation
Young the Giant - Heat of the Summer
Tyler, The Creator - Peach Fuzz
Jack Cullen - Learn
Disturbed - A Reason to Fight
Luke Combs - Beautiful Crazy (Live) (feat. Leon Bridges)
The Story So Far - Take Me as You Please
Nicky Romero - Me On You (AmPm Remix)
Noah Kahan - False Confidence
Lin-Manuel Miranda - A Forgotten Spot (Olvidado)
Elle King - Naturally Pretty Girls
Slash - The Call of the Wild (feat. Myles Kennedy and The Conspirators)
Farid Bang - INTERNATIONAL GANGSTAS
Walker McGuire - Growin' Up
Macy Gray - Over You
Stephen Carey - Wrecks Me
Sarah Reeves - I Love You
Black Honey - Crowded City
The Bright Expression - Tension
$ain't - Poolside Roulette
Hands Like Houses - Tilt
Anson Seabra - Robin Hood
Greta Van Fleet - Lover, Leaver
Jimothy Lacoste - Fashion
Tim Timmons - I Belong
Bearson - It's Not This (feat. josh pan)
Jessie Reyez - Dear Yessie
Carl Broemel - No One Else
Starley - Signs
Norah Jones - A Song With No Name
Prince - International Lover (Piano & A Microphone 1983 Version)
Samantha Barks - Long Way Home
Cloud Nothings - Leave Him Now
Hildur - Picture Perfect
Emmi - Moments
Cooper & Gatlin - Break
Blithe - Mission
Shavaun Marie - Ups & Downs
Peter Bjorn and John - Gut Feeling
13 Crowns - Grateful (feat. Poo Bear)
EDY - Not About You
Praa - Y
Emerson Leif - Twenty2
Helena Deland - Lean on You
Low Island - Hot Air
Keepitinside - Sway
Arlie - too long
MUNYA - If I'm Gone Tomorrow (It's Because of Aliens)
J Mascis - Everything She Said